N:random
T:150
S:15,17
D:0,0,0,0,0,0,0,0,0,0,0,0,0,0,0
D:0,0,0,0,0,0,0,0,0,0,0,3,0,0,0
D:3,2,2,0,0,0,0,0,0,0,0,0,0,0,3
D:3,0,0,0,3,0,0,0,0,0,0,2,3,0,3
D:0,0,0,0,0,0,0,0,0,0,0,2,0,0,0
D:0,0,0,2,0,0,0,0,0,0,3,0,0,0,0
D:0,0,2,0,3,0,0,0,0,0,0,3,2,0,3
D:0,0,0,0,0,0,0,2,3,0,0,0,0,0,0
D:0,3,0,0,0,0,0,3,0,0,0,0,0,3,0
D:0,0,0,0,0,0,3,2,0,0,0,0,0,0,0
D:3,0,2,3,0,0,0,0,0,0,3,0,2,0,0
D:0,0,0,0,3,0,0,0,0,0,0,2,0,0,0
D:0,0,0,2,0,0,0,0,0,0,0,0,0,0,0
D:3,0,3,2,0,0,0,0,0,0,3,0,0,0,3
D:3,0,0,0,0,0,0,0,0,0,0,0,2,2,3
D:0,0,0,3,0,0,0,0,0,0,0,0,0,0,0
D:0,0,0,0,0,0,0,0,0,0,0,0,0,0,0
H:8,5
C:6,11
