N:random
T:100
S:15,17
D:0,0,0,0,0,0,0,0,0,0,0,0,0,0,0
D:0,0,0,0,0,0,0,0,0,3,3,0,0,0,3
D:0,0,0,0,0,0,3,3,3,0,2,3,0,0,0
D:3,0,0,0,0,0,0,3,0,0,0,0,3,0,0
D:0,0,0,3,3,0,3,0,0,0,0,0,0,3,0
D:0,0,0,0,0,0,0,3,2,3,0,0,0,0,0
D:0,0,2,2,2,0,0,0,2,0,3,0,0,0,3
D:0,0,3,3,0,0,0,0,2,0,0,0,0,0,3
D:0,0,0,0,0,3,0,3,0,3,0,0,0,0,0
D:3,0,0,0,0,0,2,0,0,0,0,3,3,0,0
D:3,0,0,0,3,0,2,0,0,0,2,2,2,0,0
D:0,0,0,0,0,3,2,3,0,0,0,0,0,0,0
D:0,3,0,0,0,0,0,0,3,0,3,3,0,0,0
D:0,0,3,0,0,0,0,3,0,0,0,0,0,0,3
D:0,0,0,3,2,0,3,3,3,0,0,0,0,0,0
D:3,0,0,0,3,3,0,0,0,0,0,0,0,0,0
D:0,0,0,0,0,0,0,0,0,0,0,0,0,0,0
H:11,4
C:3,12
